000000000
011111000
010101000
010101000
010131110
010100010
010110110
011110100
010000310
021111110
000000000
1
1
1
1
1
1
10