000000000
011011110
031111010
001111110
000001010
011101010
021111030
000000000
1
1
1
1
1
1
1
1
1
10