000000000
011131110
011000100
011111110
001111110
011131100
011111110
011000110
021111110
000000000
1
1
1
1
1
1
1
10