000000000
001111110
001000010
001011110
001010010
001010010
021031110
00000000011111111
1
1
1
1
1
1
1
1
1