00000000011111111
01111000011111111
01311110011111111
01001011011111111
01131111011111111
00001011011111111
01111111011111111
02111000011111111
00000000011111111
11111111111111111
11111111111111111
11111111111111111
11111111111111111
11111111111111111
11111111111111111
11111111111111111
11111111111111111
10