000000000
001111000
011131100
011111110
001000100
001121110
011111110
031111110
000000000
1
1
1
1
1
1
1
1
10