00000000011111111
00111100011111111
01113110011111111
01111111011111111
00100010011111111
00112111011111111
01111111011111111
03111111011111111
00000000011111111
11111111111111111
11111111111111111
11111111111111111
11111111111111111
11111111111111111
11111111111111111
11111111111111111
11111111111111111
10