000000000
001111110
001000010
011131110
011000010
010021110
010010010
011011110
013000110
001000110
001111110
000000000
1
1
1
1
1
10