00000000011111111
01113111011111111
00100011011111111
01111110011111111
01100111011111111
00110101011111111
01111111011111111
01110101011111111
01010103011111111
02110111011111111
00000000011111111
11111111111111111
11111111111111111
11111111111111111
11111111111111111
11111111111111111
11111111111111111
10