00000000011111111
00111111011111111
00100001011111111
00101111011111111
00101001011111111
00101001011111111
02103111011111111
00000000011111111
11111111111111111
11111111111111111
11111111111111111
11111111111111111
11111111111111111
11111111111111111
11111111111111111
11111111111111111
11111111111111111
10