000000000
001111110
001000010
001011110
001010010
001010010
011011110
000000000