00000000011111111
00111111011111111
00100001011111111
01113111011111111
01100001011111111
01002111011111111
01001001011111111
01101111011111111
01300011011111111
00100011011111111
00111111011111111
00000000011111111
11111111111111111
11111111111111111
11111111111111111
11111111111111111
11111111111111111
10