00000000001111111
00111111101111111
00000010101111111
00311111301111111
00100010001111111
00111111101111111
00110010101111111
01110130101111111
01111100101111111
01010000101111111
02111111101111111
00000000001111111
11111111111111111
11111111111111111
11111111111111111
11111111111111111
11111111111111111
10