00000000011111111
01103111011111111
01101010011111111
01111110011111111
00112111011111111
01111111011111111
01000000011111111
01011111011111111
01131001011111111
01000001011111111
01111111011111111
00000000011111111
11111111111111111
11111111111111111
11111111111111111
11111111111111111
11111111111111111
10