00000000011111111
01111131011111111
01111101011111111
00000101011111111
02111111011111111
01000100011111111
01011100011111111
01010000011111111
01111111011111111
00010001011111111
01111111011111111
01000001011111111
01131111011111111
00000000011111111
11111111111111111
11111111111111111
11111111111111111
10