000000000
011111310
011111010
000001010
021111110
010001000
010111000
010100000
011111110
000100010
011111110
010000010
011311110
000000000
1
1
1
10