00000000011111111
01113111011111111
01100010011111111
01111111011111111
00111111011111111
01113110011111111
01111111011111111
01100011011111111
02111111011111111
00000000011111111
11111111111111111
11111111111111111
11111111111111111
11111111111111111
11111111111111111
11111111111111111
11111111111111111
10