0000000000
0011111110
0000001010
0031111130
0010001000
0011111110
0011001010
0111013010
0111110010
0101000010
0211111110
0000000000
1
1
1
1
1
10