000000000
031101110
010101110
011111100
000100110
011100110
020111110
000000000
1
1
1
1
1
1
1
1
1
10