00000000011111111
01111113011111111
01000001011111111
01111101011111111
01100101011111111
01111301011111111
02100001011111111
00111111011111111
00000000011111111
11111111111111111
11111111111111111
11111111111111111
11111111111111111
11111111111111111
11111111111111111
11111111111111111
11111111111111111
10