000000000
010111130
011111110
010000010
010001110
013111000
010011110
010000010
021111110
000000000
1
1
1
1
1
1
1
10