000000000
011111310
010100010
010100010
010100010
010100010
010131010
010111010
010111110
011111100
021110000
000000000
1
1
1
1
1
10