00000000001111111
01110011101111111
00013111101111111
01111111001111111
01111111101111111
00010000101111111
02111111101111111
00000000001111111
11111111111111111
11111111111111111
11111111111111111
11111111111111111
11111111111111111
11111111111111111
11111111111111111
11111111111111111
11111111111111111
10