000000000
011031110
011010100
011111100
001121110
011111110
010000000
010111110
011310010
010000010
011111110
000000000
1
1
1
1
1
10