000000000
011131110
001000110
011111100
011001110
001101010
011111110
011101010
010101030
021101110
000000000
1
1
1
1
1
1
10