000000000
010111000
010101000
010103000
010101110
010100010
030110110
011110110
010000110
021111110
000000000
1
1
1
1
1
1
10