1111111111
1000110001
1010000101
1000110101
1011100001
1000000111
1101100001
1000101001
1010001001
1111111111
