00000000011111111
00111111011111111
01131111011111111
01100101011111111
01110101011111111
01111101011111111
01010001011111111
02011113011111111
00000000011111111
11111111111111111
11111111111111111
11111111111111111
11111111111111111
11111111111111111
11111111111111111
11111111111111111
11111111111111111
10