000000000
001111100
031101130
011000110
011000110
010000010
011000110
011101110
011101110
001121100
000000000
1
1
1
1
1
1
10