00000000011111111
01101111011111111
03111101011111111
00111111011111111
00000101011111111
01110101011111111
02111103011111111
00000000011111111
11111111111111111
11111111111111111
11111111111111111
11111111111111111
11111111111111111
11111111111111111
11111111111111111
11111111111111111
11111111111111111
10