00000000011111111
01111131011111111
01010001011111111
01010001011111111
01010001011111111
01010001011111111
01013101011111111
01011101011111111
01011111011111111
01111110011111111
02111000011111111
00000000011111111
11111111111111111
11111111111111111
11111111111111111
11111111111111111
11111111111111111
10