00000000011111111
01110113011111111
01010101011111111
01111111011111111
00010100011111111
01110111011111111
01000001011111111
02111111011111111
00000000011111111
11111111111111111
11111111111111111
11111111111111111
11111111111111111
11111111111111111
11111111111111111
11111111111111111
11111111111111111
10