00000000011111111
01111100011111111
01010100011111111
01010100011111111
01013111011111111
01010001011111111
01011011011111111
01111010011111111
01000031011111111
02111111011111111
00000000011111111
11111111111111111
11111111111111111
11111111111111111
11111111111111111
11111111111111111
11111111111111111
10