000000000
011101110
010101010
011111110
000101000
011101110
010000010
011111110
000000000