000000000
010113000
010101000
010101000
010101110
010100010
010130110
011110100
010000110
021111110
000000000
1
1
1
1
1
1
10