00000001111111111
03011101111111111
01010101111111111
01111101111111111
00010001111111111
02110001111111111
00000001111111111
11111111111111111
11111111111111111
11111111111111111
11111111111111111
11111111111111111
11111111111111111
11111111111111111
11111111111111111
11111111111111111
11111111111111111
10