000000000
011111130
010000010
011111010
011001010
011113010
021000010
001111110
000000000
1
1
1
1
1
1
1
1
10