000000000
001111110
011311110
011001010
011101010
011111010
010100010
020111130
000000000
1
1
1
1
1
1
1
1
10