0000000000
0111001110
0001311110
0111111100
0111111110
0001000010
0211111110
0000000000
1
1
1
1
1
1
1
1
1
10