00000000011111111
01011113011111111
01111111011111111
01000001011111111
01000111011111111
01311100011111111
01001111011111111
01000001011111111
02111111011111111
00000000011111111
11111111111111111
11111111111111111
11111111111111111
11111111111111111
11111111111111111
11111111111111111
11111111111111111
10