000000000
011110000
013111100
010010110
011311110
000010110
011111110
021110000
000000000
1
1
1
1
1
1
1
1
10