00000000011111111
03110111011111111
01010111011111111
01111110011111111
00010011011111111
01110011011111111
02011111011111111
00000000011111111
11111111111111111
11111111111111111
11111111111111111
11111111111111111
11111111111111111
11111111111111111
11111111111111111
11111111111111111
11111111111111111
10