000000000
011101130
010101010
011111110
000101000
011101110
010000010
021111110
000000000
1
1
1
1
1
1
1
1
10