211111000000000
000001111111100
001111000000000
000001000000000
000001111111111
000001000000001
000001000000001
000001000000001
000001000000001
000001000000001
000001000000001
000001000000000
000001111111111
000001000000000
000001000000000
