00000000011111111
00111110011111111
03110113011111111
01100011011111111
01100011011111111
01000001011111111
01100011011111111
01110111011111111
01110111011111111
00112110011111111
00000000011111111
11111111111111111
11111111111111111
11111111111111111
11111111111111111
11111111111111111
11111111111111111
10